37,37,37,37,37,37,37,37,37,37,37,37,37,37,37,37,37,37,37,37
37,8,8,37,8,8,8,8,8,8,8,37,8,8,8,8,8,8,8,37
37,8,8,37,8,8,37,8,8,8,8,37,8,8,8,8,8,8,8,37
37,8,8,37,8,8,37,8,8,8,8,37,8,8,8,8,8,8,8,37
37,8,8,37,8,8,37,8,8,8,8,37,8,8,8,8,8,8,8,37
37,8,8,37,8,8,37,8,8,8,8,37,8,8,8,8,8,8,8,37
37,8,8,37,8,8,37,8,8,8,8,37,8,8,8,8,8,8,8,37
37,8,8,37,8,8,37,8,8,8,8,37,8,8,8,8,8,8,8,37
37,8,8,37,8,8,37,8,8,8,8,37,8,8,8,8,8,8,8,37
37,8,8,8,8,8,37,8,8,8,8,8,8,8,8,8,8,8,8,8
37,37,37,37,37,37,37,37,37,37,37,37,37,37,37,37,37,37,37,37